1111111111111111111-
9777000000000000001-
1007000000077777001-
1007000000070007001-
1007770000070007001-
1000077777770007001-
1000000000000007001-
1000000000000007001-
1000000000000007001-
1000000000000007779-
1111111111111111111