0000000000000000000-
1001000000000000000-
0000000000010001000-
0000000000000000000-
0001010000000000000-
0000010000010000000-
0000000000000000000-
0000000000000000000-
0000000000000000000-
0000000000000001001-
0000000000000000000